1111111111111
1M010000C0001
1C00C01M110C1
10P011E010C01
1C011C0C001M1
1111111111111




