111111111
1P00E00C1
111111111
