1111111111111
1M010000000C1
10aC011111001
1P0011EC000M1
1111111111111
